##############
#S...........#
#............#
####.#####.###
#....#...#...#
#.####.#.#.#.#
#....#.#.#.E.#
##############